NO ./tools/assets/texture-a.xpm
WE   ./tools/assets/texture-b.xpm
SO ./tools/assets/texture-c.xpm
EA ./tools/assets/texture-d.xpm

C 80,10,169
F 200,200,100



111111111111111111111
100000000000000000001
100000001000000000001
10000001 100000000001
100000001000000000001
1000000N0000000000001
111111111111111111111