NO ./tools/assets/texture-a.xpm
WE   ./tools/assets/texture-b.xpm
SO ./tools/assets/texture-c.xpm
EA ./tools/assets/texture-d.xpm

C 80,10,169
F 200,200,200


111111111111111111111111111111111111
1000000000110000000000000000000000011111111111111111111111111111111111111111111111111111111111111111111
1000000000110000000000000000000000000000000000000000000000000000000000000000000000000000000000000000001
1000000000110000000000000000000000000000000000000000000000000000000000000000000000000000000000000000001
1000000000110000000000000000000000000000000000000000000000000000000000000000000000000000000000000000001
1000100000110000000000000000000000011111111111111111111111111111111111111111111111111111111110000000001
100000000011000000000000000000000001                                                        10000000001
100000000011000000000000000000000001                                                        10000000001
100000000011000000000000000000000001                                                        10000000001
100000000011000000000000000000000001                                                        10000000001
100000000011000000000000000000000001                                                        10000000001
100000000011000N00000100000000000001                                                        10000000001
100000000000000000001000000000000001                                                        10000000001
100000000000000000000000000000000001                                                        10000000001
100000000000000000000000000000000001   11111111                                             1111100001
100000000000000000000000000000000001   100000001                                                 100001
100000000011000000000000000000000001111100000001                                                 100001
100000000011000000000000000000000000000000000001                       11111111111111111111111111100001
100000000011000000000000000000000000000000000001                       10000000000000000000000000000001111111111111111111111111111111111111111111111111111111111111111111111
100000000011000000000000000000000001111111001111                       10000000000000000000000000000000000000000000000000000000000000000000000000000000000000000000000000001
100000000011000000000000000000000001111111001111                       10000000000000000000000000000000000000000000000000000000000000000000000000000000000000000000000000001
100000000011000000000000000000000001111100000001                       10000000011111111111111111111111111111111111111111111111111111111111111111111111111111111111111110001
100000000011000000000000000000000001    10000111                       1000000001                                                                                      10001
100000000011000000000000000000000001    10000111111111111111111111111111000000001                                                                                      10001
111111111111111111111111111111111111    10000000000000000000000000000000000000001                                                                                      10001
                                        11100000000000000000000000000000000000001                                                                                      10001
111111111111111111111111111111111111111111100000000000000000000000000000000000001                                                                                      10001
100000000011000000000000000000000000000000000001111111111111111111111111111111111                                                                                      10001
100000000000000000000000000000000011111111111111                                                                                                                       10001
10000000000000000000000000000000001111                                                                                                                                 10001
10000000000000000000000000000000000001                                                                                                                                 10001
10000000000000000000000000000000000001                                                                                                                                 10001
10000000000000000000000000000000000001                                                                                                                                 10001
10000000000000000000000000000000000001                                                                                                                                 10001
10000000000000000000000000000000000001111111111111111111111111111111111111111111111111111111111111111111111111111111111111111111111111111111111111111111111111111       10001
10000000000000000000000000000000000000000000000000000000000000000000000000000000000000000000000000000000000000000000000000000000000000000000000000000000000000001       10001
10000000000000000000000000000000000000000000000000000000000000000000000000000000000000000000000000000000000000000000000000000000000000000000000000000000000000001111111110001
10000000000000000000000000000000000000000000000000000000000000000000000000000000000000000000000000000000000000000000000000000000000000000000000000000000000000000000000000001
10000000000000000000000000000000000000000000000000000000000000000000000000000000000000000000000000000000000000000000000000000000000000000000000000000000000000001111111111111
10000000000000000000000000000000000000000000000000000000000000000000000000000000000000000000000000000000000000000000000000000000000000000000000000000000000000001
10000000000000000000000000000000000000000000000000000000000000000000000000000000000000000000000000000000000000000000000000000000000000000000000000000000000000001
10000000000000000000000000000000000000000000000000000000000000000000000000000000000000000000000000000000000000000000000000000000000000000000000000000000000000001
10000000000000000000000000000000000000000000000000000000000000000000000000000000000000000000000000000000000000000000000000000000000000000000000000000000000000001
10000000000000000000000000000000000001111111111111111111111111111111111111111111111111111111111111111111111111111111111111111111111111111111111111111111111111111
10000000000000000000000000000000000001
10000000000000000000000000000000000001
10000000000000000000000000000000000001
10000000000000000000000000000000000001
10000000000000000000000000000000000001
10000000000000000000000000000000000001
10000000000000000000000000000000000001
10000000000000000000000000000000000001
10000000000000000000000000000000000001
10000000000000000000000000000000000001
10000000000000000000000000000000000001
10000000000000000000000000000000000001
10000000000000000000000000000000000001
10000000000000000000000000000000000001
10000000000000000000000000000000000001
10000000000000000000000000000000000001
10000000000000000000000000000000000001
10000000000000000000000000000000000001
10000000000000000000000000000000000001
10000000000000000000000000000000000001
10000000000000000000000000000000000001
10000000000000000000000000000000000001
10000000000000000000000000000000000001
10000000000000000000000000000000000001
10000000000000000000000000000000000001
10000000000000000000000000000000000001
10000000000000000000000000000000000001
10000000000000000000000000000000000001
10000000000000000000000000000000000001
10000000000000000000000000000000000001
10000000000000000000000000000000000001
10000000000000000000000000000000000001
10000000000000000000000000000000000001
10000000000000000000000000000000000001
10000000000000000000000000000000000001
10000000000000000000000000000000000001
10000000000000000000000000000000000001
10000000000000000000000000000000000001
10000000000000000000000000000000000001
10000000000000000000000000000000000001
10000000000000000000000000000000000001
10000000000000000000000000000000000001
10000000000000000000000000000000000001
10000000000000000000000000000000000001
10000000000000000000000000000000000001
10000000000000000000000000000000000001
10000000000000000000000000000000000001
10000000000000000000000000000000000001
10000000000000000000000000000000000001
10000000000000000000000000000000000001
10000000000000000000000000000000000001
10000000000000000000000000000000000001
10000000000000000000000000000000000001
10000000000000000000000000000000000001
10000000000000000000000000000000000001
10000000000000000000000000000000000001
10000000000000000000000000000000000001
10000000000000000000000000000000000001
10000000000000000000000000000000000001
10000000000000000000000000000000000001
10000000000000000000000000000000000001
10000000000000000000000000000000000001
10000000000000000000000000000000000001
10000000000000000000000000000000000001
10000000000000000000000000000000000001
10000000000000000000000000000000000001
10000000000000000000000000000000000001
10000000000000000000000000000000000001
10000000000000000000000000000000000001
10000000000000000000000000000000000001
10000000000000000000000000000000000001
10000000000000000000000000000000000001
10000000000000000000000000000000000001
10000000000000000000000000000000000001
10000000000000000000000000000000000001
10000000000000000000000000000000000001
11111111111111111111111111111111111111

